1.  Albania (Tirana): Aeropuerto Internacional Madre Teresa (TIA)
2.  Alemania (Berlin): Aeropuerto de Berlin-Tegel (TXL)
3.  Andorra(Andorra la Vieja): Aeropuerto Andorra-La Seu (LEU)
4.  Armenia(Erevan): Aeropuerto Internacional El Eden (AXM)
5.  Austria(Viena): Aeropuerto Internacional de Viena (VIE)
6.  Azerbaiyan(Baku): Aeropuerto Internacional Heydar Aliyev (GYD)
7.  Belgica(Bruselas): Aeropuerto de Bruselas-Zaventem (BRU)
8.  Bielorrusia(Minsk): Aeropuerto Internacional de Minsk (MSQ)
9.  Bosnia(Sarajevo): Aeropuerto de Banja Luka-Zaluzani (LQBZ)
10. Bulgaria(Sofia): Aeropuerto de Sofia (SOF) 
11. Chipre(Nicosia): Aeropuerto Internacional de Larnaca (LCA)
12. Ciudad del Vaticano(Ciudad del Vaticano): Aeropuerto Internacional Leonardo da Vinci (FCO)
13. Croacia(Zagreb): Aeropuerto de Zagreb  (ZAG)  
14. Dinamarca(Copenhague): Aeropuerto de Copenhague-Kastrup (CPH) 
15. Eslovaquia(Bratislava):Aeropuerto Milan Rastislav Stefanik (BTS)
16. Eslovenia(Liubliana): Aeropuerto de Liubliana (LJU)
17. Espanya(Madrid): Adolfo Suarez Madrid-Barajas  (MAD)  
18. Estonia(Tallin): Aeropuerto de Tallin (TLL)
19. Rusia(Moscu):Aeropuerto Internacional de Moscu-Domodedovo (DME)
20. Finlandia(Helsinki): Aeropuerto de Helsinki-Vantaa (HEL)
21. Francia(Paris): Aeropuerto de Paris-Orly (ORY)
22. Georgia(Tiflis): Aeropuerto Internacional de Tiflis (TBS)
23. Grecia(Atenas): Aeropuerto Internacional Eleftherios Venizelos (ATH) 
24. Hungria(Budapest): Aeropuerto de Budapest-Ferihegy (BUD)
25. Irlanda(Dublin): Aeropuerto de Dublin (DUB)
26. Islandia(Reikiavik): Aeropuerto Internacional de Keflavik (KEF) 
27. Italia(Roma): Aeropuerto de Roma-Fiumicino (FCO)  
28. Kazajistan(Astana): Aeropuerto Internacional de Almaty (ALA)
29. Letonia(Riga): Aeropuerto Internacional de Riga (RIX)
30. Lituania(Vilna): Aeropuerto Internacional de Vilna (VNO)
31. Luxemburgo(Luxemburgo): Aeropuerto Internacional de Luxemburgo (LUX) 
32. Macedonia del Norte(Skopie): Aeropuerto Internacional de Skopje (SKP) 
33. Malta(La Valeta): Aeropuerto Internacional de Malta (MLA)
34. Moldova(Chisinau): Aeropuerto Internacional de Chisinau (KIV)
35. Montenegro(Podgorica): Aeropuerto de Podgorica (TGD)
36. Noruega(Oslo): Aeropuerto de Oslo-Gardermoen (OSL)
37. Paises Bajos(Amsterdam): Aeropuerto de Schiphol (AMS)
38. Polonia(Varsovia): Aeropuerto de Breslavia-Copernico (WRO)
39. Portugal(Lisboa): Aeropuerto de Portela (LIS)
40. Reino Unido(Londres): Aeropuerto de Londres-Heathrow (LHR)
41. Republica Checa(Praga): Aeropuerto de Praga (PRG)
42. Rumania(Bucarest): Aeropuerto Internacional Henri Coanda (OTP)
43. San Marino(San Marino): Aeropuerto Internacional Federico Fellini (RMI)
44. Serbia(Belgrado): Aeropuerto de Belgrado-Nikola Tesla (BEG)
45. Suecia(Estocolmo): Aeropuerto de Estocolmo-Arlanda (ARN)
46. Suiza(Berna): Aeropuerto Internacional de Ginebra (GVA)
47. Ucrania(Kiev): Aeropuerto Internacional de Boryspil (KBP)
